1111111 
1     1 
11111 1 
1     1 
1 11111 
1    91 
1111111 