1111111 
10 1  1 
11   21 
1   111 
1 11191 
1     1 
1111111 